111111111111111111111111111
1P100C00111100C0000C00C0001
101011101001111111111111101
1010100010010000C0000C000C1
1C1011111001010111111111101
101000001001010000C00C001C1
101111101111010111111111101
100000100000010100C00000C01
111110C11110110111111111101
100C001000C00010C0000C00101
101110101011111111011111101
10100010100C0000C0000000001
101011101111111111111111101
101E101000C0000C0000C000001
1010100000000000000000000C1
100C000000C00000C0000C00001
111111111111111111111111111
